Player,Team,Pos,G,MP,GS,FG,FGA,FG%,3P,3PA,3P%,2P,2PA,2P%,FT,FTA,FT%,ORB,DRB,TRB,AST,STL,BLK,TOV,PF,PTS
DeWanna Bonner,TOT,G-F,10,218,3,21,61,0.344,9,27,0.333,12,34,0.353,20,22,0.909,5,35,40,16,11,1,9,14,71
Haley Jones,TOT,F-G,7,87,0,10,23,0.435,1,4,0.25,9,19,0.474,0,0,,3,13,16,7,2,1,2,8,21
Liatu King,TOT,F,14,136,0,13,27,0.481,1,6,0.167,12,21,0.571,11,15,0.733,12,17,29,4,2,0,11,14,38
Tiffany Mitchell,TOT,G,17,230,2,18,45,0.4,4,14,0.286,14,31,0.452,24,31,0.774,8,24,32,7,6,3,14,29,64
NaLyssa Smith,TOT,F,22,441,18,57,130,0.438,2,12,0.167,55,118,0.466,37,59,0.627,37,77,114,18,11,19,25,61,153
Julie Vanloo,TOT,G,12,209,2,20,57,0.351,14,46,0.304,6,11,0.545,5,6,0.833,2,17,19,42,6,0,27,20,59
Li Yueru,TOT,C,18,299,6,27,72,0.375,8,19,0.421,19,53,0.358,35,40,0.875,33,47,80,15,5,2,22,38,97
Monique Akoa-Makani,PHO,G,20,416,20,60,132,0.455,25,59,0.424,35,73,0.479,26,26,1.0,14,27,41,53,20,1,28,53,171
Julie Allemand,LAS,G,11,235,4,15,36,0.417,10,28,0.357,5,8,0.625,4,4,1.0,5,26,31,34,9,0,18,18,44
Lindsay Allen,CON,G,14,201,3,11,32,0.344,1,9,0.111,10,23,0.435,7,9,0.778,0,10,10,31,3,3,14,18,30
Rebecca Allen,CHI,F-G,19,383,9,45,119,0.378,21,64,0.328,24,55,0.436,10,16,0.625,9,55,64,27,10,13,22,24,121
Laeticia Amihere,GSV,F,9,155,0,26,46,0.565,0,4,0.0,26,42,0.619,16,23,0.696,14,42,56,16,4,8,18,20,68
Ariel Atkins,CHI,G,19,573,19,89,216,0.412,27,76,0.355,62,140,0.443,58,68,0.853,12,51,63,70,36,17,47,63,263
Shakira Austin,WAS,C-F,17,360,9,81,171,0.474,0,5,0.0,81,166,0.488,48,73,0.658,33,77,110,27,16,16,39,41,210
Marième Badiane,MIN,C,3,11,0,0,3,0.0,0,1,0.0,0,2,0.0,0,0,,1,0,1,0,2,0,2,6,0
Rachel Banham,CHI,G,19,385,8,46,118,0.39,35,92,0.38,11,26,0.423,19,20,0.95,4,16,20,42,10,2,17,34,146
Sarah Ashlee Barker,LAS,G,19,357,7,24,75,0.32,15,47,0.319,9,28,0.321,14,18,0.778,7,43,50,21,10,4,32,38,77
Kierstan Bell,LVA,F,15,140,0,18,54,0.333,11,37,0.297,7,17,0.412,6,6,1.0,6,17,23,3,4,5,5,8,53
Grace Berger,LAS,G,1,16,0,0,4,0.0,0,2,0.0,0,2,0.0,0,0,,1,0,1,1,0,0,3,1,0
Chloe Bibby,GSV,F,5,66,0,11,27,0.407,8,19,0.421,3,8,0.375,2,2,1.0,3,11,14,3,3,0,0,6,32
Monique Billings,GSV,F,17,330,7,55,110,0.5,7,26,0.269,48,84,0.571,22,36,0.611,25,61,86,8,12,15,16,31,139
Aliyah Boston,IND,F-C,20,598,20,133,229,0.581,4,14,0.286,129,215,0.6,53,68,0.779,48,114,162,73,15,22,30,70,323
Crystal Bradford,LVA,F,4,24,0,2,6,0.333,0,2,0.0,2,4,0.5,0,0,,2,3,5,1,2,0,1,3,4
Jaelyn Brown,CON,G-F,10,131,0,14,37,0.378,8,18,0.444,6,19,0.316,1,2,0.5,4,8,12,1,5,2,5,17,37
Kalani Brown,PHO,C,18,248,0,39,62,0.629,2,6,0.333,37,56,0.661,16,20,0.8,23,48,71,13,5,11,19,34,96
Lexie Brown,SEA,G,13,91,0,2,15,0.133,2,14,0.143,0,1,0.0,6,8,0.75,0,6,6,5,4,0,2,11,12
Paige Bueckers,DAL,G,16,556,16,105,235,0.447,17,52,0.327,88,183,0.481,63,72,0.875,11,54,65,87,27,13,35,44,290
Kennedy Burke,NYL,G-F,19,440,6,60,120,0.5,34,70,0.486,26,50,0.52,22,30,0.733,13,34,47,21,24,13,21,28,176
Rae Burrell,LAS,G-F,4,33,0,4,10,0.4,1,2,0.5,3,8,0.375,0,0,,1,5,6,0,0,0,2,4,9
Veronica Burton,GSV,G,19,546,19,56,162,0.346,25,73,0.342,31,89,0.348,69,81,0.852,23,53,76,100,23,9,36,43,206
Maya Caldwell,ATL,G,18,211,3,22,66,0.333,7,34,0.206,15,32,0.469,2,4,0.5,13,20,33,18,11,3,15,23,53
Jordin Canada,ATL,G,13,347,13,49,121,0.405,12,40,0.3,37,81,0.457,27,38,0.711,4,41,45,66,23,2,23,22,137
Emma Cannon,LAS,F,18,198,0,31,58,0.534,14,32,0.438,17,26,0.654,14,21,0.667,10,25,35,7,9,1,13,36,90
Kamilla Cardoso,CHI,C,15,346,14,78,139,0.561,1,1,1.0,77,138,0.558,30,44,0.682,43,54,97,28,5,13,31,45,187
Bridget Carleton,MIN,F,21,622,21,52,128,0.406,27,82,0.329,25,46,0.543,6,8,0.75,19,52,71,56,20,5,19,44,137
DiJonai Carrington,DAL,G-F,14,376,12,57,160,0.356,13,45,0.289,44,115,0.383,38,46,0.826,34,39,73,29,19,6,39,40,165
Kaila Charles,DAL,G-F,17,269,4,29,80,0.363,10,30,0.333,19,50,0.38,22,27,0.815,25,43,68,18,9,4,16,32,90
Tina Charles,CON,C,20,564,19,114,280,0.407,4,18,0.222,110,262,0.42,82,93,0.882,29,77,106,30,15,7,48,37,314
Kaitlyn Chen,GSV,G,7,110,0,11,19,0.579,3,5,0.6,8,14,0.571,4,6,0.667,3,7,10,10,3,0,7,5,29
Sonia Citron,WAS,G,20,669,20,96,211,0.455,32,87,0.368,64,124,0.516,61,69,0.884,16,86,102,39,21,6,34,42,285
Alysha Clark,SEA,F,20,390,7,30,75,0.4,16,46,0.348,14,29,0.483,11,13,0.846,7,40,47,17,16,2,13,40,87
Caitlin Clark,IND,G,11,351,11,64,170,0.376,26,90,0.289,38,80,0.475,32,40,0.8,1,53,54,95,15,6,59,32,186
Natasha Cloud,NYL,G,18,515,18,63,150,0.42,22,69,0.319,41,81,0.506,33,35,0.943,8,59,67,112,25,6,35,56,181
Nia Coffey,ATL,F,20,231,2,27,75,0.36,15,48,0.313,12,27,0.444,19,28,0.679,14,45,59,23,5,7,18,26,88
Napheesa Collier,MIN,F,18,602,18,158,303,0.521,21,68,0.309,137,235,0.583,86,90,0.956,41,102,143,60,28,28,44,44,423
Sydney Colson,IND,G,19,272,6,19,48,0.396,9,29,0.31,10,19,0.526,6,7,0.857,5,12,17,42,10,5,21,23,53
Zia Cooke,SEA,G,20,215,0,22,69,0.319,10,30,0.333,12,39,0.308,9,15,0.6,6,5,11,12,9,1,16,22,63
Kahleah Copper,PHO,G-F,6,145,6,31,73,0.425,13,29,0.448,18,44,0.409,25,31,0.806,3,18,21,11,8,1,17,18,100
Sophie Cunningham,IND,G,15,341,0,25,70,0.357,17,48,0.354,8,22,0.364,20,22,0.909,9,53,62,12,13,2,17,34,87
Damiris Dantas,IND,C-F,15,190,0,24,63,0.381,11,35,0.314,13,28,0.464,17,20,0.85,11,28,39,7,3,3,11,30,76
Marquesha Davis,NYL,G,9,31,0,1,4,0.25,0,3,0.0,1,1,1.0,6,7,0.857,1,4,5,1,0,1,3,2,8
Kadidja Diaby,CON,C,13,103,0,7,14,0.5,0,0,,7,14,0.5,11,14,0.786,3,10,13,5,6,1,12,19,25
Skylar Diggins,SEA,G,21,682,21,128,286,0.448,34,84,0.405,94,202,0.465,93,119,0.782,10,38,48,124,25,14,52,56,383
Stefanie Dolson,WAS,C,20,328,11,21,70,0.3,8,39,0.205,13,31,0.419,5,5,1.0,8,37,45,30,7,6,18,55,55
Aaliyah Edwards,WAS,F,16,234,0,35,75,0.467,0,6,0.0,35,69,0.507,23,38,0.605,21,37,58,8,10,5,21,25,93
Emily Engstler,WAS,F,17,180,0,16,38,0.421,4,18,0.222,12,20,0.6,7,12,0.583,19,39,58,21,8,9,15,20,43
Dana Evans,LVA,G,20,342,0,45,124,0.363,17,48,0.354,28,76,0.368,21,28,0.75,4,12,16,35,10,2,18,25,128
Temi Fagbenle,GSV,C,14,348,13,51,98,0.52,5,26,0.192,46,72,0.639,14,21,0.667,32,48,80,27,17,10,27,50,121
Sania Feagin,LAS,F,6,21,0,1,8,0.125,0,3,0.0,1,5,0.2,0,2,0.0,0,2,2,1,0,3,4,4,2
Leonie Fiebich,NYL,F,12,314,12,30,59,0.508,17,37,0.459,13,22,0.591,10,13,0.769,9,42,51,10,10,8,17,30,87
Rebekah Gardner,NYL,G,19,267,4,31,63,0.492,9,22,0.409,22,41,0.537,12,14,0.857,14,24,38,11,9,5,8,36,83
Luisa Geiselsoder,DAL,C,10,230,6,25,57,0.439,6,22,0.273,19,35,0.543,2,3,0.667,12,33,45,14,7,11,10,21,58
Allisha Gray,ATL,G,20,717,20,118,260,0.454,48,119,0.403,70,141,0.496,90,108,0.833,20,88,108,79,18,10,36,55,374
Chelsea Gray,LVA,G,20,609,20,85,194,0.438,34,90,0.378,51,104,0.49,50,56,0.893,15,70,85,85,25,12,68,44,254
Brittney Griner,ATL,C,18,421,18,71,142,0.5,2,10,0.2,69,132,0.523,36,46,0.783,17,84,101,15,2,22,31,43,180
Megan Gustafson,LVA,C,1,22,0,2,8,0.25,0,4,0.0,2,4,0.5,0,0,,0,4,4,0,0,1,1,1,4
Bree Hall,GSV,G,2,8,0,1,2,0.5,0,1,0.0,1,1,1.0,1,3,0.333,0,2,2,0,0,0,2,1,3
Dearica Hamby,LAS,F,20,648,20,129,240,0.538,8,30,0.267,121,210,0.576,69,113,0.611,52,100,152,74,38,11,58,56,335
Isabelle Harrison,NYL,F,17,150,0,24,50,0.48,1,5,0.2,23,45,0.511,5,9,0.556,12,33,45,12,8,0,9,20,54
Tyasha Harris,DAL,G,5,82,0,8,18,0.444,5,11,0.455,3,7,0.429,2,2,1.0,1,4,5,13,2,2,3,5,23
Bria Hartley,CON,G,20,442,14,50,151,0.331,24,73,0.329,26,78,0.333,34,41,0.829,5,35,40,59,18,0,36,53,158
Tiffany Hayes,GSV,G,12,315,10,53,122,0.434,20,49,0.408,33,73,0.452,32,36,0.889,7,41,48,30,6,2,25,25,158
Lexi Held,PHO,G,14,290,0,43,110,0.391,20,64,0.313,23,46,0.5,16,20,0.8,8,16,24,20,21,5,18,18,122
Natisha Hiedeman,MIN,G,21,398,0,62,137,0.453,15,58,0.259,47,79,0.595,26,34,0.765,2,42,44,66,10,4,24,35,165
Naz Hillmon,ATL,F,20,408,0,50,103,0.485,19,57,0.333,31,46,0.674,20,26,0.769,28,70,98,40,10,7,22,31,139
Myisha Hines-Allen,DAL,F,21,453,15,56,115,0.487,7,23,0.304,49,92,0.533,26,37,0.703,22,86,108,60,17,10,49,56,145
Joyner Holmes,LVA,F,6,29,0,3,12,0.25,1,5,0.2,2,7,0.286,0,0,,2,4,6,0,0,0,2,5,7
Mackenzie Holmes,SEA,F,4,19,0,2,3,0.667,0,0,,2,3,0.667,0,0,,2,2,4,1,0,1,0,2,4
Natasha Howard,IND,F,20,482,20,91,171,0.532,4,17,0.235,87,154,0.565,38,56,0.679,40,92,132,23,19,9,44,58,224
Rhyne Howard,ATL,G,19,670,19,99,284,0.349,56,185,0.303,43,99,0.434,60,75,0.8,21,74,95,86,31,18,37,62,314
Lexie Hull,IND,G,20,577,16,61,134,0.455,26,56,0.464,35,78,0.449,14,23,0.609,30,69,99,34,21,4,18,57,162
Sabrina Ionescu,NYL,G,18,567,18,110,277,0.397,47,145,0.324,63,132,0.477,82,88,0.932,14,69,83,96,29,7,48,24,349
Kiki Iriafen,WAS,F,20,538,20,90,196,0.459,0,2,0.0,90,194,0.464,64,83,0.771,55,113,168,28,14,3,38,67,244
Rickea Jackson,LAS,F,15,451,14,68,171,0.398,16,59,0.271,52,112,0.464,29,37,0.784,9,32,41,27,11,5,35,30,181
Aziaha James,DAL,G,17,347,6,50,134,0.373,17,54,0.315,33,80,0.413,28,34,0.824,15,33,48,34,13,5,20,24,145
Moriah Jefferson,CHI,G,3,14,0,0,2,0.0,0,1,0.0,0,1,0.0,0,0,,0,0,0,4,0,0,1,2,0
Marine Johannes,NYL,G,19,352,1,46,107,0.43,29,85,0.341,17,22,0.773,6,7,0.857,9,36,45,27,14,4,28,23,127
Brionna Jones,ATL,F,20,590,20,105,205,0.512,6,28,0.214,99,177,0.559,56,76,0.737,65,91,156,46,22,10,31,54,272
Jonquel Jones,NYL,C,9,206,9,38,80,0.475,14,32,0.438,24,48,0.5,19,29,0.655,17,69,86,21,5,10,15,19,109
Elizabeth Kitley,LVA,C,12,98,1,7,23,0.304,0,1,0.0,7,22,0.318,1,2,0.5,4,13,17,1,4,6,7,18,15
Sika Koné,WAS,F,10,71,0,7,17,0.412,1,2,0.5,6,15,0.4,6,7,0.857,3,14,17,5,0,0,6,10,21
Anastasiia Kosu,MIN,F,9,23,0,3,9,0.333,0,0,,3,9,0.333,5,6,0.833,4,0,4,1,0,2,2,1,11
Leïla Lacan,CON,G,3,75,0,8,21,0.381,1,10,0.1,7,11,0.636,6,6,1.0,4,7,11,5,0,0,7,13,23
Kitija Laksa,PHO,F,19,443,5,56,139,0.403,33,92,0.359,23,47,0.489,13,18,0.722,8,18,26,18,8,3,12,29,158
Carla Leite,GSV,G,13,213,3,30,78,0.385,3,33,0.091,27,45,0.6,25,29,0.862,5,10,15,26,9,1,19,23,88
Kyara Linskens,GSV,C,4,27,0,2,5,0.4,0,1,0.0,2,4,0.5,0,0,,1,5,6,1,1,3,2,7,4
Jewell Loyd,LVA,G,20,599,20,74,195,0.379,40,107,0.374,34,88,0.386,29,34,0.853,28,57,85,44,18,2,27,38,217
Marina Mabrey,CON,G,13,410,13,69,189,0.365,30,102,0.294,39,87,0.448,30,35,0.857,7,58,65,52,8,7,36,46,198
Natasha Mack,PHO,F,10,157,2,13,27,0.481,0,2,0.0,13,25,0.52,5,10,0.5,23,28,51,8,11,12,7,19,31
Ezi Magbegor,SEA,F-C,21,573,21,69,139,0.496,2,20,0.1,67,119,0.563,25,43,0.581,45,87,132,51,14,43,18,60,165
Dominique Malonga,SEA,C,21,190,0,43,85,0.506,0,7,0.0,43,78,0.551,9,13,0.692,15,44,59,15,4,3,21,28,95
Rayah Marshall,CON,C-F,8,49,0,4,13,0.308,0,1,0.0,4,12,0.333,3,6,0.5,5,12,17,3,0,1,5,4,11
Kate Martin,GSV,G,18,315,2,43,121,0.355,25,73,0.342,18,48,0.375,19,25,0.76,4,43,47,12,7,2,18,21,130
Kayla McBride,MIN,G,17,537,17,72,176,0.409,42,112,0.375,30,64,0.469,48,51,0.941,2,36,38,54,18,2,28,23,234
Megan McConnell,PHO,G,1,13,0,1,4,0.25,1,2,0.5,0,2,0.0,0,0,,1,0,1,3,1,0,0,1,3
Teaira McCowan,DAL,C,12,174,0,27,49,0.551,1,2,0.5,26,47,0.553,13,17,0.765,22,36,58,6,4,10,12,20,68
Aari McDonald,IND,G,9,243,4,28,68,0.412,8,36,0.222,20,32,0.625,21,29,0.724,3,15,18,38,10,2,13,24,85
Jade Melbourne,WAS,G,19,442,4,44,111,0.396,16,49,0.327,28,62,0.452,17,34,0.5,8,32,40,51,9,1,34,48,121
Diamond Miller,MIN,F,18,175,0,21,44,0.477,11,20,0.55,10,24,0.417,18,21,0.857,2,14,16,15,6,4,14,32,71
Kelsey Mitchell,IND,G,20,625,20,139,308,0.451,46,123,0.374,93,185,0.503,60,81,0.741,6,27,33,55,18,5,30,43,384
Aneesah Morrow,CON,F,17,246,2,40,102,0.392,6,23,0.261,34,79,0.43,33,43,0.767,23,49,72,10,13,6,18,37,119
Murjanatu Musa,PHO,C,12,122,0,16,35,0.457,1,2,0.5,15,33,0.455,7,11,0.636,18,13,31,7,4,2,7,17,40
Olivia Nelson-Ododa,CON,C,19,447,17,60,120,0.5,0,1,0.0,60,119,0.504,49,66,0.742,34,85,119,18,13,27,23,46,169
Kia Nurse,CHI,G,19,412,11,47,123,0.382,31,86,0.36,16,37,0.432,14,18,0.778,6,32,38,22,6,2,25,38,139
Aaliyah Nye,LVA,G-F,20,354,0,34,86,0.395,22,59,0.373,12,27,0.444,10,13,0.769,5,22,27,11,6,4,11,37,100
Arike Ogunbowale,DAL,G,18,613,18,99,273,0.363,33,109,0.303,66,164,0.402,71,76,0.934,5,43,48,70,27,5,42,47,302
Nneka Ogwumike,SEA,F,21,660,21,147,282,0.521,24,67,0.358,123,215,0.572,38,46,0.826,31,133,164,51,29,14,43,44,356
Lucy Olsen,WAS,G,18,186,0,24,55,0.436,9,23,0.391,15,32,0.469,8,9,0.889,3,16,19,16,2,1,6,17,65
Michaela Onyenwere,CHI,F,19,254,4,32,78,0.41,7,22,0.318,25,56,0.446,15,17,0.882,6,24,30,22,8,1,19,37,86
Te-Hina PaoPao,ATL,G,19,233,4,35,72,0.486,20,43,0.465,15,29,0.517,6,9,0.667,5,20,25,32,4,2,15,24,96
Robyn Parks,CON,F,6,63,0,1,5,0.2,0,4,0.0,1,1,1.0,0,0,,1,8,9,2,2,0,1,7,2
Shey Peddy,LAS,G,6,138,5,10,24,0.417,5,13,0.385,5,11,0.455,5,6,0.833,6,12,18,16,2,0,4,13,30
Haley Peters,CON,F-G,19,278,2,20,57,0.351,4,23,0.174,16,34,0.471,8,11,0.727,17,33,50,19,9,3,16,35,52
Alissa Pili,MIN,F,14,82,0,10,22,0.455,4,11,0.364,6,11,0.545,3,4,0.75,4,13,17,3,2,0,7,11,27
Kelsey Plum,LAS,G,19,679,19,110,288,0.382,47,136,0.346,63,152,0.414,112,123,0.911,3,58,61,112,26,3,63,59,379
Aerial Powers,GSV,G,2,7,0,0,2,0.0,0,0,,0,2,0.0,2,2,1.0,1,1,2,1,1,0,0,0,2
Alexis Prince,PHO,F,1,22,0,1,3,0.333,0,1,0.0,1,2,0.5,0,0,,0,8,8,1,0,0,3,1,2
JJ Quinerly,DAL,G,19,241,4,42,94,0.447,10,24,0.417,32,70,0.457,23,25,0.92,8,18,26,38,12,3,22,39,117
Angel Reese,CHI,F,19,595,19,87,205,0.424,4,17,0.235,83,188,0.441,74,94,0.787,77,167,244,72,29,11,69,63,252
Saniya Rivers,CON,G,18,493,15,52,148,0.351,11,50,0.22,41,98,0.418,22,31,0.71,14,38,52,56,30,18,31,31,137
Mercedes Russell,LAS,C,20,163,0,12,27,0.444,0,0,,12,27,0.444,10,14,0.714,10,14,24,12,5,4,7,17,34
Nyara Sabally,NYL,C,13,246,8,31,63,0.492,0,5,0.0,31,58,0.534,17,25,0.68,23,38,61,8,9,9,11,29,79
Satou Sabally,PHO,F,18,509,18,108,277,0.39,34,110,0.309,74,167,0.443,94,114,0.825,28,110,138,47,25,9,43,58,344
Janelle Salaün,GSV,F,11,265,8,36,102,0.353,16,47,0.34,20,55,0.364,10,11,0.909,11,44,55,12,4,1,19,24,98
Karlie Samuelson,MIN,G,16,228,4,14,42,0.333,12,34,0.353,2,8,0.25,13,14,0.929,3,17,20,17,6,1,11,26,53
Jacy Sheldon,CON,G,20,497,15,60,119,0.504,26,60,0.433,34,59,0.576,13,14,0.929,16,21,37,41,18,4,27,51,159
Jessica Shepard,MIN,F,17,330,3,47,79,0.595,0,1,0.0,47,78,0.603,27,47,0.574,42,73,115,42,9,2,25,23,121
Jaylyn Sherrod,NYL,G,15,96,0,6,20,0.3,3,11,0.273,3,9,0.333,7,9,0.778,2,9,11,10,10,0,10,17,22
Maddy Siegrist,DAL,F,11,264,3,42,97,0.433,7,30,0.233,35,67,0.522,12,22,0.545,28,29,57,5,4,5,4,21,103
Odyssey Sims,LAS,G,12,354,11,40,96,0.417,12,34,0.353,28,62,0.452,26,34,0.765,6,29,35,42,10,1,17,27,118
Alanna Smith,MIN,F,20,530,20,79,163,0.485,26,78,0.333,53,85,0.624,14,30,0.467,31,78,109,53,20,46,32,56,198
Azura Stevens,LAS,F-C,20,583,20,105,207,0.507,31,83,0.373,74,124,0.597,46,60,0.767,37,135,172,39,30,27,33,54,287
Breanna Stewart,NYL,F,19,618,19,126,267,0.472,12,58,0.207,114,209,0.545,108,133,0.812,19,104,123,71,25,24,42,37,372
Kiah Stokes,LVA,C,20,392,18,16,46,0.348,2,19,0.105,14,27,0.519,5,8,0.625,24,89,113,15,10,8,11,37,39
Sug Sutton,WAS,G,19,469,19,50,107,0.467,21,52,0.404,29,55,0.527,17,23,0.739,3,26,29,58,21,3,29,24,138
Brittney Sykes,WAS,G,17,549,17,87,231,0.377,16,45,0.356,71,186,0.382,107,138,0.775,9,55,64,77,18,5,54,50,297
Stephanie Talbot,GSV,F,16,268,10,20,59,0.339,8,32,0.25,12,27,0.444,9,14,0.643,14,39,53,32,9,1,19,21,57
Taylor Thierry,ATL,G-F,10,15,0,1,4,0.25,1,2,0.5,0,2,0.0,0,0,,0,1,1,0,1,0,0,1,3
Alyssa Thomas,PHO,F,15,460,15,93,173,0.538,0,1,0.0,93,172,0.541,44,64,0.688,26,87,113,142,24,6,47,38,230
Kayla Thornton,GSV,F,19,572,19,94,246,0.382,37,128,0.289,57,118,0.483,61,74,0.824,36,99,135,25,29,3,32,42,286
Makayla Timpson,IND,F-C,12,76,0,9,18,0.5,0,0,,9,18,0.5,6,10,0.6,5,16,21,0,6,4,4,15,24
Brianna Turner,IND,F-C,13,53,0,2,10,0.2,0,0,,2,10,0.2,1,2,0.5,2,7,9,3,0,1,4,7,5
Sevgi Uzun,PHO,G,7,102,0,3,14,0.214,1,8,0.125,2,6,0.333,4,6,0.667,0,6,6,14,4,3,10,9,11
Maria Kliundikova,MIN,F,11,107,1,19,37,0.514,3,9,0.333,16,28,0.571,6,9,0.667,13,19,32,6,9,10,6,13,47
Courtney Vandersloot,CHI,G,7,191,7,29,66,0.439,5,23,0.217,24,43,0.558,11,13,0.846,2,20,22,37,11,2,17,13,74
Hailey Van Lith,CHI,G,17,209,0,22,62,0.355,4,21,0.19,18,41,0.439,18,23,0.783,2,15,17,22,7,4,21,11,66
Shatori Walker-Kimbrough,ATL,G,20,182,1,11,35,0.314,3,16,0.188,8,19,0.421,4,7,0.571,2,14,16,12,5,6,7,14,29
Kathryn Westbeld,PHO,F,20,456,20,49,127,0.386,23,76,0.303,26,51,0.51,15,18,0.833,17,47,64,24,24,17,11,42,136
Maddy Westbeld,CHI,F,9,60,0,5,16,0.313,3,8,0.375,2,8,0.25,2,2,1.0,5,10,15,3,3,2,5,8,15
Erica Wheeler,SEA,G,21,569,14,88,205,0.429,34,87,0.391,54,118,0.458,26,31,0.839,10,56,66,79,25,5,36,46,236
Sami Whitcomb,PHO,G,19,501,14,72,171,0.421,43,117,0.368,29,54,0.537,23,27,0.852,11,57,68,48,18,4,27,37,210
Courtney Williams,MIN,G,21,581,21,121,280,0.432,31,80,0.388,90,200,0.45,21,26,0.808,12,91,103,124,33,5,52,44,294
Elizabeth Williams,CHI,C-F,19,378,4,65,138,0.471,0,0,,65,138,0.471,23,44,0.523,29,55,84,29,14,14,20,27,153
Gabby Williams,SEA,F,21,712,21,114,248,0.46,35,101,0.347,79,147,0.537,31,38,0.816,14,84,98,95,54,11,46,31,294
Kiana Williams,PHO,G,4,42,0,9,15,0.6,3,7,0.429,6,8,0.75,0,0,,0,5,5,4,1,0,1,0,21
A'ja Wilson,LVA,C,16,484,16,110,243,0.453,5,23,0.217,105,220,0.477,106,124,0.855,23,116,139,52,27,39,39,31,331
Jackie Young,LVA,G,20,602,20,115,270,0.426,32,105,0.305,83,165,0.503,75,84,0.893,26,60,86,75,21,8,50,54,337
Cecilia Zandalasini,GSV,F,5,101,2,13,31,0.419,8,19,0.421,5,12,0.417,8,9,0.889,1,8,9,6,6,1,6,12,42
