Player,Team,Pos,G,MP,GS,FG,FGA,FG%,3P,3PA,3P%,2P,2PA,2P%,FT,FTA,FT%,ORB,DRB,TRB,AST,STL,BLK,TOV,PF,PTS
Grace Berger,TOT,G,17,374,11,21,79,0.266,1,20,0.05,20,59,0.339,10,15,0.667,9,48,57,51,13,7,19,36,53
Chloe Bibby,TOT,F,14,154,0,21,55,0.382,17,42,0.405,4,13,0.308,8,9,0.889,5,20,25,7,8,1,7,13,67
DeWanna Bonner,TOT,G-F,31,735,4,102,248,0.411,37,113,0.327,65,135,0.481,75,86,0.872,27,102,129,36,27,9,26,41,316
DiJonai Carrington,TOT,G-F,31,680,14,107,277,0.386,23,72,0.319,84,205,0.41,66,82,0.805,48,77,125,48,34,13,59,78,303
Kaila Charles,TOT,G-F,32,536,9,65,153,0.425,23,62,0.371,42,91,0.462,35,44,0.795,43,82,125,29,24,5,31,60,188
Alysha Clark,TOT,F,40,779,13,55,149,0.369,24,88,0.273,31,61,0.508,17,22,0.773,15,98,113,49,26,3,22,75,151
Marquesha Davis,TOT,G,11,52,0,2,10,0.2,0,4,0.0,2,6,0.333,6,7,0.857,3,4,7,1,0,2,6,3,10
Aaliyah Edwards,TOT,F,33,477,0,65,138,0.471,0,8,0.0,65,130,0.5,53,82,0.646,43,73,116,19,15,14,40,52,183
Haley Jones,TOT,F-G,26,541,14,79,172,0.459,12,36,0.333,67,136,0.493,22,32,0.688,18,72,90,56,18,19,39,58,192
Liatu King,TOT,F,14,136,0,13,27,0.481,1,6,0.167,12,21,0.571,11,15,0.733,12,17,29,4,2,0,11,14,38
Sika Koné,TOT,F,17,81,0,7,19,0.368,1,4,0.25,6,15,0.4,12,13,0.923,3,15,18,5,0,0,6,12,27
Diamond Miller,TOT,F,38,405,1,52,125,0.416,16,45,0.356,36,80,0.45,33,44,0.75,10,34,44,29,11,6,32,60,153
Tiffany Mitchell,TOT,G,39,510,3,40,102,0.392,11,30,0.367,29,72,0.403,35,47,0.745,11,31,42,12,14,8,24,52,126
Shey Peddy,TOT,G,13,229,5,21,47,0.447,12,31,0.387,9,16,0.563,7,9,0.778,7,16,23,28,3,0,11,20,61
Alissa Pili,TOT,F,17,92,0,10,23,0.435,4,12,0.333,6,11,0.545,12,14,0.857,4,14,18,3,2,0,8,13,36
Aerial Powers,TOT,G,8,120,0,19,50,0.38,3,14,0.214,16,36,0.444,10,15,0.667,9,23,32,16,6,0,8,12,51
Jacy Sheldon,TOT,G,30,708,17,83,178,0.466,36,91,0.396,47,87,0.54,22,25,0.88,22,35,57,57,27,6,31,72,224
Jaylyn Sherrod,TOT,G,24,127,0,7,26,0.269,3,13,0.231,4,13,0.308,9,13,0.692,2,11,13,12,10,0,12,19,26
Odyssey Sims,TOT,G,22,615,19,80,195,0.41,21,63,0.333,59,132,0.447,40,51,0.784,8,46,54,81,15,1,31,46,221
NaLyssa Smith,TOT,F,43,910,39,124,250,0.496,7,24,0.292,117,226,0.518,64,104,0.615,72,152,224,30,23,29,50,127,319
Brittney Sykes,TOT,G,38,1157,37,171,448,0.382,31,100,0.31,140,348,0.402,163,211,0.773,18,102,120,152,47,14,97,97,536
Stephanie Talbot,TOT,F,36,528,10,38,101,0.376,16,55,0.291,22,46,0.478,18,28,0.643,26,75,101,66,19,6,38,41,110
Sevgi Uzun,TOT,G,22,374,2,25,80,0.313,5,27,0.185,20,53,0.377,9,14,0.643,1,27,28,51,11,3,39,34,64
Julie Vanloo,TOT,G,32,412,2,32,101,0.317,25,84,0.298,7,17,0.412,8,10,0.8,4,25,29,64,15,0,46,41,97
Li Yueru,TOT,C,31,519,12,62,153,0.405,20,55,0.364,42,98,0.429,43,50,0.86,52,89,141,29,9,9,30,57,187
Monique Akoa Makani,PHO,G,38,831,37,107,253,0.423,46,116,0.397,61,137,0.445,36,38,0.947,23,60,83,103,30,3,51,93,296
Julie Allemand,LAS,G,32,900,25,59,146,0.404,24,95,0.253,35,51,0.686,13,17,0.765,11,112,123,162,39,0,52,52,155
Lindsay Allen,CON,G,28,368,6,23,55,0.418,3,15,0.2,20,40,0.5,14,17,0.824,8,15,23,54,10,6,29,31,63
Rebecca Allen,CHI,F-G,41,757,15,76,220,0.345,39,120,0.325,37,100,0.37,19,31,0.613,15,91,106,51,20,21,37,58,210
Laeticia Amihere,GSV,F,28,380,0,51,113,0.451,2,20,0.1,49,93,0.527,49,63,0.778,35,89,124,27,17,13,30,36,153
Yvonne Anderson,MIN,G,1,12,0,0,3,0.0,0,1,0.0,0,2,0.0,0,0,,0,1,1,2,2,0,0,3,0
Ariel Atkins,CHI,G,34,971,34,162,365,0.444,43,119,0.361,119,246,0.484,80,93,0.86,23,91,114,122,53,24,84,102,447
Shakira Austin,WAS,F-C,36,821,28,181,388,0.466,2,14,0.143,179,374,0.479,93,139,0.669,54,176,230,63,41,41,87,76,457
Marième Badiane,MIN,C,3,11,0,0,3,0.0,0,1,0.0,0,2,0.0,0,0,,1,0,1,0,2,0,2,6,0
Rachel Banham,CHI,G,41,982,30,120,308,0.39,82,221,0.371,38,87,0.437,45,50,0.9,6,58,64,104,23,10,61,79,367
Sarah Ashlee Barker,LAS,G,31,420,7,28,88,0.318,17,53,0.321,11,35,0.314,17,22,0.773,9,50,59,25,10,4,33,42,90
Kierstan Bell,LVA,F,34,414,15,52,152,0.342,30,101,0.297,22,51,0.431,12,15,0.8,20,41,61,23,13,11,14,26,146
Monique Billings,GSV,F,23,416,8,66,140,0.471,8,32,0.25,58,108,0.537,34,51,0.667,35,74,109,12,14,19,20,39,174
Aliyah Boston,IND,C-F,42,1266,42,260,482,0.539,6,29,0.207,254,453,0.561,110,145,0.759,102,240,342,155,49,41,80,130,636
Crystal Bradford,LVA,F,4,24,0,2,6,0.333,0,2,0.0,2,4,0.5,0,0,,2,3,5,1,2,0,1,3,4
Cameron Brink,LAS,F,16,210,0,29,67,0.433,10,28,0.357,19,39,0.487,16,19,0.842,24,41,65,7,8,23,24,44,84
Jaelyn Brown,CON,G-F,10,131,0,14,37,0.378,8,18,0.444,6,19,0.316,1,2,0.5,4,8,12,1,5,2,5,17,37
Kalani Brown,PHO,C,27,332,1,53,87,0.609,2,7,0.286,51,80,0.638,21,27,0.778,31,76,107,16,7,16,21,41,129
Lexie Brown,SEA,G,24,227,0,17,48,0.354,10,37,0.27,7,11,0.636,7,10,0.7,2,15,17,23,9,1,6,20,51
Paige Bueckers,DAL,G,34,1138,34,243,517,0.47,37,115,0.322,206,402,0.512,127,143,0.888,22,105,127,180,56,15,70,79,650
Kennedy Burke,NYL,G-F,34,745,9,98,211,0.464,45,108,0.417,53,103,0.515,41,54,0.759,20,57,77,44,28,16,30,45,282
Rae Burrell,LAS,G-F,25,436,0,62,143,0.434,17,53,0.321,45,90,0.5,27,39,0.692,14,42,56,28,12,4,20,32,168
Veronica Burton,GSV,G,41,1195,41,137,350,0.391,60,167,0.359,77,183,0.421,155,174,0.891,46,135,181,241,44,26,85,94,489
Maya Caldwell,ATL,G,39,708,16,78,183,0.426,37,103,0.359,41,80,0.513,14,18,0.778,32,83,115,71,34,7,38,58,207
Jordin Canada,ATL,G,26,749,25,104,266,0.391,25,86,0.291,79,180,0.439,71,94,0.755,8,79,87,149,45,8,57,45,304
Emma Cannon,LAS,F,20,206,0,32,62,0.516,14,35,0.4,18,27,0.667,15,23,0.652,11,26,37,7,9,1,15,36,93
Kamilla Cardoso,CHI,C,37,1001,36,204,383,0.533,1,2,0.5,203,381,0.533,90,126,0.714,107,201,308,90,13,40,90,108,499
Bridget Carleton,MIN,F,41,1147,41,98,239,0.41,61,159,0.384,37,80,0.463,17,23,0.739,36,113,149,82,35,11,29,78,274
Tina Charles,CON,C,40,1141,39,243,554,0.439,12,44,0.273,231,510,0.453,159,184,0.864,60,175,235,68,33,17,77,85,657
Kaitlyn Chen,GSV,G,23,242,0,19,50,0.38,5,15,0.333,14,35,0.4,5,7,0.714,5,17,22,24,5,0,18,16,48
Sonia Citron,WAS,G,42,1347,42,212,453,0.468,76,174,0.437,136,279,0.487,127,145,0.876,29,139,168,100,51,16,84,89,627
Caitlin Clark,IND,G,13,404,13,72,196,0.367,29,104,0.279,43,92,0.467,41,50,0.82,1,64,65,115,21,7,66,35,214
Natasha Cloud,NYL,G,39,1142,39,146,335,0.436,51,149,0.342,95,186,0.511,58,67,0.866,14,135,149,205,48,14,72,116,401
Nia Coffey,ATL,F,42,430,2,51,137,0.372,22,76,0.289,29,61,0.475,36,50,0.72,25,83,108,45,10,15,29,45,160
Napheesa Collier,MIN,F,31,1001,31,261,492,0.53,43,112,0.384,218,380,0.574,151,167,0.904,60,172,232,101,51,49,67,75,716
Sydney Colson,IND,G,30,404,6,26,76,0.342,13,47,0.277,13,29,0.448,6,7,0.857,7,18,25,60,15,6,35,34,71
Zia Cooke,SEA,G,26,261,0,30,84,0.357,15,38,0.395,15,46,0.326,15,23,0.652,6,8,14,14,10,1,22,26,90
Kahleah Copper,PHO,G-F,25,686,25,141,329,0.429,52,133,0.391,89,196,0.454,69,81,0.852,11,66,77,40,29,5,57,68,403
Sophie Cunningham,IND,G,30,756,13,82,175,0.469,51,118,0.432,31,57,0.544,42,48,0.875,15,90,105,36,29,3,34,65,257
Damiris Dantas,IND,C-F,36,410,0,57,170,0.335,20,87,0.23,37,83,0.446,22,26,0.846,26,57,83,25,6,3,29,56,156
Kariata Diaby,CON,C,13,103,0,7,14,0.5,0,0,,7,14,0.5,11,14,0.786,3,10,13,5,6,1,12,19,25
Skylar Diggins,SEA,G,42,1314,42,225,527,0.427,62,168,0.369,163,359,0.454,145,184,0.788,24,80,104,252,52,34,88,97,657
Stefanie Dolson,WAS,C,41,621,14,59,137,0.431,26,71,0.366,33,66,0.5,14,20,0.7,16,75,91,57,12,13,27,90,158
Emily Engstler,WAS,F,38,492,0,52,131,0.397,16,62,0.258,36,69,0.522,22,34,0.647,34,86,120,54,28,25,37,51,142
Dana Evans,LVA,G,41,716,1,100,256,0.391,34,92,0.37,66,164,0.402,40,53,0.755,6,36,42,82,17,5,32,52,274
Temi Fagbenle,GSV,C,36,836,35,113,224,0.504,11,56,0.196,102,168,0.607,25,34,0.735,61,116,177,59,31,20,54,109,262
Sania Feagin,LAS,F,14,65,0,8,25,0.32,0,4,0.0,8,21,0.381,0,2,0.0,3,7,10,1,0,6,7,13,16
Leonie Fiebich,NYL,F,35,999,35,105,212,0.495,50,114,0.439,55,98,0.561,53,60,0.883,22,105,127,64,33,14,45,85,313
Rebekah Gardner,NYL,G,39,472,5,49,101,0.485,16,37,0.432,33,64,0.516,20,24,0.833,25,47,72,25,22,7,22,60,134
Luisa Geiselsoder,DAL,C,28,628,24,76,179,0.425,31,94,0.33,45,85,0.529,9,11,0.818,24,109,133,44,22,19,28,67,192
Allisha Gray,ATL,G,40,1410,40,238,534,0.446,93,246,0.378,145,288,0.503,176,220,0.8,34,181,215,142,45,14,73,108,745
Chelsea Gray,LVA,G,41,1275,41,154,357,0.431,55,155,0.355,99,202,0.49,92,104,0.885,22,134,156,220,52,27,118,83,455
Brittney Griner,ATL,C,37,774,25,144,282,0.511,5,19,0.263,139,263,0.529,62,82,0.756,34,163,197,32,5,40,58,73,355
Megan Gustafson,LVA,C,17,200,0,15,47,0.319,11,33,0.333,4,14,0.286,7,15,0.467,7,24,31,5,2,5,5,39,48
Bree Hall,GSV,G,3,12,0,1,3,0.333,0,2,0.0,1,1,1.0,1,3,0.333,0,2,2,0,0,0,3,3,3
Dearica Hamby,LAS,F,41,1292,41,304,523,0.581,14,52,0.269,290,471,0.616,134,217,0.618,104,222,326,133,64,20,111,116,756
Isabelle Harrison,NYL,F,32,343,1,64,126,0.508,4,13,0.308,60,113,0.531,33,43,0.767,27,57,84,22,20,2,21,43,165
Tyasha Harris,DAL,G,5,82,0,8,18,0.444,5,11,0.455,3,7,0.429,2,2,1.0,1,4,5,13,2,2,3,5,23
Bria Hartley,CON,G,38,867,32,106,293,0.362,54,147,0.367,52,146,0.356,71,92,0.772,11,64,75,117,29,0,68,95,337
Tiffany Hayes,GSV,G,26,700,24,99,237,0.418,41,101,0.406,58,136,0.426,64,80,0.8,18,82,100,77,14,4,49,58,303
Lexi Held,PHO,G,29,435,0,57,154,0.37,27,88,0.307,30,66,0.455,18,22,0.818,11,21,32,30,23,5,25,36,159
Natisha Hiedeman,MIN,G,41,755,0,134,275,0.487,37,106,0.349,97,169,0.574,43,57,0.754,9,68,77,116,26,7,47,64,348
Naz Hillmon,ATL,F,42,1062,15,130,287,0.453,50,159,0.314,80,128,0.625,49,59,0.831,68,194,262,100,17,19,48,70,359
Myisha Hines-Allen,DAL,F,38,825,18,104,223,0.466,15,52,0.288,89,171,0.52,57,78,0.731,51,166,217,103,30,17,85,95,280
Joyner Holmes,LVA,F,6,29,0,3,12,0.25,1,5,0.2,2,7,0.286,0,0,,2,4,6,0,0,0,2,5,7
Mackenzie Holmes,SEA,F,10,58,0,5,7,0.714,0,0,,5,7,0.714,0,0,,3,6,9,2,5,1,0,7,10
Natasha Howard,IND,F,42,1016,42,191,346,0.552,6,30,0.2,185,316,0.585,85,121,0.702,83,196,279,63,50,25,83,113,473
Rhyne Howard,ATL,G,31,1092,30,175,473,0.37,97,303,0.32,78,170,0.459,97,114,0.851,31,108,139,143,46,26,50,91,544
Lexie Hull,IND,G,42,1143,28,113,284,0.398,54,142,0.38,59,142,0.415,26,36,0.722,61,124,185,73,49,7,40,113,306
Sabrina Ionescu,NYL,G,36,1141,36,223,558,0.4,80,264,0.303,143,294,0.486,150,161,0.932,29,146,175,196,47,16,97,60,676
Kiki Iriafen,WAS,F,42,1133,42,211,431,0.49,2,11,0.182,209,420,0.498,133,167,0.796,112,253,365,65,25,7,89,121,557
Rickea Jackson,LAS,F,36,1130,35,199,467,0.426,63,178,0.354,136,289,0.471,79,94,0.84,37,81,118,61,23,14,77,70,540
Aziaha James,DAL,G,36,631,8,97,263,0.369,30,103,0.291,67,160,0.419,39,52,0.75,32,67,99,58,22,7,34,44,263
Moriah Jefferson,CHI,G,5,35,1,3,8,0.375,1,3,0.333,2,5,0.4,0,0,,0,5,5,9,0,0,2,3,7
Marine Johannes,NYL,G,42,790,5,99,249,0.398,64,186,0.344,35,63,0.556,16,19,0.842,13,71,84,68,24,12,52,45,278
Brionna Jones,ATL,F,42,1133,42,216,408,0.529,12,46,0.261,204,362,0.564,99,128,0.773,133,179,312,93,46,36,63,106,543
Jonquel Jones,NYL,C,29,782,29,144,289,0.498,52,119,0.437,92,170,0.541,64,84,0.762,44,193,237,78,14,32,64,74,404
Elizabeth Kitley,LVA,C,12,98,1,7,23,0.304,0,1,0.0,7,22,0.318,1,2,0.5,4,13,17,1,4,6,7,18,15
Anastasiia Kosu,MIN,F,19,63,0,10,24,0.417,0,1,0.0,10,23,0.435,9,13,0.692,6,4,10,3,1,2,5,6,29
Leïla Lacan,CON,G,24,640,14,100,209,0.478,15,65,0.231,85,144,0.59,30,36,0.833,17,41,58,92,54,4,44,78,245
Kitija Laksa,PHO,G,31,586,5,63,173,0.364,36,115,0.313,27,58,0.466,23,29,0.793,11,27,38,19,12,6,17,42,185
Kyra Lambert,IND,G,1,0,0,0,0,,0,0,,0,0,,0,0,,0,0,0,0,0,0,0,0,0
Carla Leite,GSV,G,34,610,6,86,215,0.4,13,72,0.181,73,143,0.51,82,97,0.845,9,38,47,71,24,3,54,54,267
Kyara Linskens,GSV,C,4,27,0,2,5,0.4,0,1,0.0,2,4,0.5,0,0,,1,5,6,1,1,3,2,7,4
Jewell Loyd,LVA,G,41,1160,25,152,393,0.387,86,231,0.372,66,162,0.407,59,70,0.843,48,88,136,80,45,7,52,80,449
Marina Mabrey,CON,G,32,997,31,161,452,0.356,62,229,0.271,99,223,0.444,67,77,0.87,17,120,137,126,21,10,87,94,451
Natasha Mack,PHO,F-C,31,569,20,67,112,0.598,0,4,0.0,67,108,0.62,15,32,0.469,74,110,184,27,29,51,13,52,149
Ezi Magbegor,SEA,F-C,43,1177,43,139,281,0.495,12,46,0.261,127,235,0.54,57,83,0.687,82,181,263,92,29,93,39,123,347
Dominique Malonga,SEA,C,41,578,0,141,256,0.551,4,18,0.222,137,238,0.576,28,48,0.583,52,136,188,35,17,26,47,85,314
Rayah Marshall,CON,C-F,13,80,0,9,24,0.375,0,1,0.0,9,23,0.391,5,10,0.5,6,18,24,4,2,1,6,9,23
Kate Martin,GSV,G,39,649,4,85,253,0.336,57,175,0.326,28,78,0.359,32,41,0.78,17,86,103,38,17,4,33,47,259
Kayla McBride,MIN,G,36,1134,36,172,397,0.433,101,242,0.417,71,155,0.458,93,103,0.903,9,75,84,128,45,2,60,48,538
Megan McConnell,PHO,G,1,13,0,1,4,0.25,1,2,0.5,0,2,0.0,0,0,,1,0,1,3,1,0,0,1,3
Teaira McCowan,DAL,C,17,219,0,36,67,0.537,1,2,0.5,35,65,0.538,22,29,0.759,30,48,78,10,5,12,16,24,95
Aari McDonald,IND,G,20,525,13,66,154,0.429,24,78,0.308,42,76,0.553,40,51,0.784,9,38,47,94,25,3,46,50,196
Emma Meesseman,NYL,F,15,403,12,80,142,0.563,12,18,0.667,68,124,0.548,23,28,0.821,18,60,78,51,19,12,33,24,195
Jade Melbourne,WAS,G,41,966,12,85,216,0.394,26,93,0.28,59,123,0.48,49,73,0.671,17,63,80,116,25,7,68,97,245
Kelsey Mitchell,IND,G,42,1330,42,304,671,0.453,107,273,0.392,197,398,0.495,147,188,0.782,18,58,76,146,37,7,72,86,862
Aneesah Morrow,CON,F,38,691,20,102,267,0.382,16,64,0.25,86,203,0.424,61,76,0.803,74,171,245,20,30,17,41,74,281
Murjanatu Musa,PHO,C,12,122,0,16,35,0.457,1,2,0.5,15,33,0.455,7,11,0.636,18,13,31,7,4,2,7,17,40
Olivia Nelson-Ododa,CON,C,37,800,21,113,215,0.526,1,2,0.5,112,213,0.526,78,111,0.703,60,124,184,34,27,43,40,89,305
Kia Nurse,CHI,G,41,885,17,93,268,0.347,56,168,0.333,37,100,0.37,47,60,0.783,17,78,95,53,14,2,51,69,289
Aaliyah Nye,LVA,G-F,41,615,0,56,156,0.359,35,106,0.33,21,50,0.42,14,17,0.824,15,47,62,19,13,9,26,51,161
Arike Ogunbowale,DAL,G,29,966,29,147,404,0.364,48,158,0.304,99,246,0.402,108,116,0.931,10,62,72,120,39,7,60,74,450
Nneka Ogwumike,SEA,F,43,1327,43,313,604,0.518,66,176,0.375,247,428,0.577,95,114,0.833,57,244,301,99,49,17,84,83,787
Amy Okonkwo,DAL,F,6,113,1,20,41,0.488,5,18,0.278,15,23,0.652,14,16,0.875,3,14,17,6,7,1,5,10,59
Lucy Olsen,WAS,G,39,479,0,61,150,0.407,19,68,0.279,42,82,0.512,14,17,0.824,10,34,44,46,14,4,21,44,155
Michaela Onyenwere,CHI,F,39,626,19,78,188,0.415,20,59,0.339,58,129,0.45,33,40,0.825,15,45,60,46,14,4,48,65,209
Te-Hina PaoPao,ATL,G,41,674,14,91,205,0.444,50,123,0.407,41,82,0.5,7,13,0.538,10,54,64,95,18,8,40,45,239
Robyn Parks,CON,F,6,63,0,1,5,0.2,0,4,0.0,1,1,1.0,0,0,,1,8,9,2,2,0,1,7,2
Haley Peters,CON,F-G,30,360,2,23,77,0.299,6,37,0.162,17,40,0.425,10,13,0.769,23,49,72,24,11,3,21,49,62
Kelsey Plum,LAS,G,40,1417,40,246,575,0.428,92,261,0.352,154,314,0.49,211,235,0.898,9,117,126,232,50,4,124,109,795
Alexis Prince,PHO,F,1,22,0,1,3,0.333,0,1,0.0,1,2,0.5,0,0,,0,8,8,1,0,0,3,1,2
JJ Quinerly,DAL,G,34,539,13,80,188,0.426,21,54,0.389,59,134,0.44,39,45,0.867,18,45,63,78,29,7,52,70,220
Angel Reese,CHI,F,30,947,30,153,334,0.458,4,22,0.182,149,312,0.478,130,172,0.756,123,254,377,111,44,20,118,103,440
Saniya Rivers,CON,G,39,1002,23,126,308,0.409,38,112,0.339,88,196,0.449,43,58,0.741,26,79,105,101,60,35,55,64,333
Iliana Rupert,GSV,C,18,411,8,58,130,0.446,39,85,0.459,19,45,0.422,11,12,0.917,16,48,64,28,9,10,16,44,166
Mercedes Russell,LAS,C,20,163,0,12,27,0.444,0,0,,12,27,0.444,10,14,0.714,10,14,24,12,5,4,7,17,34
Nyara Sabally,NYL,C,15,291,10,35,71,0.493,1,7,0.143,34,64,0.531,17,25,0.68,26,48,74,13,9,16,16,36,88
Satou Sabally,PHO,F,36,967,36,190,482,0.394,60,194,0.309,130,288,0.451,147,176,0.835,49,166,215,91,45,13,73,107,587
Janelle Salaün,GSV,F,33,875,30,133,323,0.412,55,151,0.364,78,172,0.453,44,54,0.815,24,134,158,39,19,3,48,66,365
Karlie Samuelson,MIN,G,16,228,4,14,42,0.333,12,34,0.353,2,8,0.25,13,14,0.929,3,17,20,17,6,1,11,26,53
Madison Scott,WAS,G-F,7,41,0,5,11,0.455,0,1,0.0,5,10,0.5,2,2,1.0,1,0,1,2,2,0,1,6,12
Jessica Shepard,MIN,F,37,745,10,114,181,0.63,0,1,0.0,114,180,0.633,53,96,0.552,80,179,259,96,15,3,54,41,281
Maddy Siegrist,DAL,F,24,652,13,122,248,0.492,25,75,0.333,97,173,0.561,38,56,0.679,47,58,105,18,18,14,13,50,307
Kamiah Smalls,ATL,G,3,3,0,0,0,,0,0,,0,0,,0,0,,0,0,0,0,0,0,0,0,0
Alanna Smith,MIN,F,40,1076,40,157,317,0.495,52,154,0.338,105,163,0.644,27,61,0.443,62,148,210,114,52,75,64,113,393
Azura Stevens,LAS,F-C,41,1166,41,196,401,0.489,71,176,0.403,125,225,0.556,72,92,0.783,70,250,320,87,49,47,63,93,535
Breanna Stewart,NYL,F,29,897,29,174,382,0.455,19,84,0.226,155,298,0.52,161,194,0.83,29,160,189,102,39,40,60,58,528
Kiah Stokes,LVA,C,37,487,18,17,48,0.354,3,21,0.143,14,27,0.519,5,8,0.625,27,113,140,16,16,12,16,47,42
Serena Sundell,DAL,G,3,22,0,0,1,0.0,0,1,0.0,0,0,,0,0,,0,1,1,0,0,0,2,4,0
Sug Sutton,WAS,G,41,1071,41,115,267,0.431,41,115,0.357,74,152,0.487,37,48,0.771,8,63,71,161,31,3,79,57,308
Camryn Taylor,MIN,F,4,9,0,0,0,,0,0,,0,0,,0,0,,0,2,2,0,0,0,1,2,0
Taylor Thierry,ATL,G-F,17,36,0,2,11,0.182,1,3,0.333,1,8,0.125,1,4,0.25,2,4,6,2,4,0,1,1,6
Alyssa Thomas,PHO,F,36,1154,36,229,425,0.539,0,5,0.0,229,420,0.545,114,162,0.704,61,262,323,332,57,17,128,76,572
Kayla Thornton,GSV,F,22,662,22,100,276,0.362,40,142,0.282,60,134,0.448,68,82,0.829,40,114,154,33,29,5,36,52,308
Makayla Timpson,IND,F-C,29,211,0,32,57,0.561,0,0,,32,57,0.561,15,23,0.652,18,39,57,1,13,7,8,24,79
Mamignan Touré,CON,G,15,107,0,10,27,0.37,6,16,0.375,4,11,0.364,0,0,,1,1,2,6,5,0,6,16,26
Brianna Turner,IND,F-C,25,213,0,11,27,0.407,0,1,0.0,11,26,0.423,3,4,0.75,16,28,44,14,2,8,7,23,25
Maria Kliundikova,MIN,F,31,341,1,57,115,0.496,8,23,0.348,49,92,0.533,12,21,0.571,38,49,87,19,24,24,21,43,134
Courtney Vandersloot,CHI,G,7,191,7,29,66,0.439,5,23,0.217,24,43,0.558,11,13,0.846,2,20,22,37,11,2,17,13,74
Hailey Van Lith,CHI,G,29,361,0,37,109,0.339,5,31,0.161,32,78,0.41,23,31,0.742,4,27,31,45,12,4,36,22,102
Shatori Walker-Kimbrough,ATL,G,39,345,1,26,62,0.419,11,30,0.367,15,32,0.469,8,11,0.727,3,29,32,21,10,11,15,24,71
Kathryn Westbeld,PHO,F,40,738,24,74,205,0.361,41,125,0.328,33,80,0.413,18,24,0.75,26,73,99,37,32,22,21,62,207
Maddy Westbeld,CHI,F,23,280,1,28,81,0.346,11,31,0.355,17,50,0.34,6,8,0.75,19,31,50,16,9,6,15,36,73
Erica Wheeler,SEA,G,43,1094,24,162,407,0.398,71,197,0.36,91,210,0.433,43,50,0.86,16,98,114,142,56,9,67,108,438
Sami Whitcomb,PHO,G,40,974,20,122,311,0.392,80,222,0.36,42,89,0.472,42,50,0.84,16,95,111,107,31,7,62,82,366
Christyn Williams,DAL,G,2,32,0,3,10,0.3,1,3,0.333,2,7,0.286,4,6,0.667,2,0,2,3,0,0,1,2,11
Courtney Williams,MIN,G,41,1172,41,235,541,0.434,57,143,0.399,178,398,0.447,44,52,0.846,22,176,198,257,50,13,95,80,571
Elizabeth Williams,CHI,C-F,41,871,13,150,312,0.481,0,0,,150,312,0.481,50,81,0.617,74,138,212,74,29,37,52,59,350
Gabby Williams,SEA,F,43,1368,43,197,464,0.425,50,164,0.305,147,300,0.49,64,75,0.853,24,164,188,179,98,21,82,63,508
Kiana Williams,PHO,G,9,78,0,12,25,0.48,5,15,0.333,7,10,0.7,1,2,0.5,0,8,8,7,1,0,2,3,30
A'ja Wilson,LVA,C,37,1157,37,308,613,0.502,19,53,0.358,289,560,0.516,237,279,0.849,82,290,372,112,57,82,84,74,872
Jackie Young,LVA,G,41,1248,41,240,517,0.464,70,204,0.343,170,313,0.543,125,139,0.899,51,132,183,198,53,16,93,103,675
Cecilia Zandalasini,GSV,F,17,423,10,64,138,0.464,37,83,0.446,27,55,0.491,26,29,0.897,5,48,53,32,16,4,20,32,191
